XXXXXXXXXXXXXXXXXXXXXXXXXXXXXXXXXXXXXXXX
XTTTTTTTTXXXXXXXXXXXXXXXXXXXXTTTTTTTTTTX
XTTTTTTTTTTTTTTTTTXXXXXXXXXXXXXXTTTTJTTX
XTTTTTTTTTTTTTTTTTTTTTTTTXXXXXXXXXXTTTTX
XTXXXXTTTTTTTTTTTTTTTTTTTTTTTTTTTTTTTTTX
XTXXXXTTTTTTTTTTTTTTTTTTTTTTTTTTTTTTTTTX
XTTXXXXTTT{}{}{}TTTTTTTTTTTTTTTTTTTTTTTX
XTTXXXXTTT[][][]XXTTTTTTTXXTTTTTTTTTTTTX
XXXXXTTTTTTTTTXXXXXXXXXXXTTTTTTTTTTTTTTX
XXXXXXXXTTTTTTTTTXXXXXTTTTTTTTTTTTTTTTTX
XXXXXXXXXXXXXTTTTTXXXTTTTTTTXXXXXXXXXXXX
XXXXXXXXXXXXXTTTTTTTTTTTTTTTXXXXXXXXXXXX
XXXXXXXXXXXXXTJTTTTTTTTTTTTTXXXXXXXXXXXX
XXXXXXXXXXXTTTTTTTTTTTTTTTTTTTTTTTTTTTTX
XXXXXXXXXTTTTTTTTWWWWWTTTTTTTTTTTTJTTTTX
XXXXXXXTT{}{}{}TTTTTTTTTT{}{}{}TTTTTTTTX
XXXXXTTTT[][][]TTTTTTTTTT[][][]TTTTTTTTX
XXXXTTTTTTTTTTTTTTTTTTTTTXXXXXXXXXXXXTTX
XXXXTTJTTTTTTTTTTTTTTTTTTXXXXXXXXXXXXTTX
XXXTTTTTTTTTTTTTTTTTTTTTTXXXXXXXXXXXXTTX
XxTTTTTTXXXXXXXXXTTTTTTTTTTTTTTTTTTTTTTX
XXXTTTTTTTTTTTTTTTTTTTTTTTTTTTTTTTJTTTTX
XXXXXTTTTJTTTTTTTTTTTTTTTTTTTTTTTTTTTTTX
XXXXXTTTTTTTTTTTTTTTTTTTTTTTTTTTTTTTTTTX
XXXXXXXXXXXTTTTTTTTTTTTTTTTTTTTTTTTTTTTX
XTTTXXXXXXXXTTTTTTTTTTTTTTTTTTTTTTTTTTTX
XTKKTTTTXXXTTTTTTTTTTTTTTTTTTTTTTTTTTTTX
XTKKTTTTTTTTTTTTTTTTTTTTTTTTTTTTTTTTTTTX
XTTTTTTTTTTTTTTTTTTTTTTTTTTTTTTTTTTTTTTX
XXXXXXXXXXXXXXXXXXXXXXXXXXXXXXXXXXXXXXXX