TTTTTTTTTTTTTTTTTTTTTTTTTTTTTTTTTTTTTTTT
TTTTTTTTTTTTTTTTTTTTTTTTTTTTTTTTTTTTTTTT
TTTTTTTTTTTTTTTTTTTTTTTTTTTTTTTTTTTTTTTT
TTTTTFFFFFFFFFFTTTTTTTTTTTTTTTTTTTTTTTTT
TTTTTFFFFFFFFFFTTTTTTTTTTTTTTTTTTTTTTTTT
TTTTTFFFFFFFFFFTTTTTTTTTTTTTTTTTTTTTTTTT
TTTTTFFFFFFFFFFTTTTTTTTTTTTTTTTTTTTTTTTT
TTTTTFFFFFFFFFFTTTTTTTTTTTTTTTTTTTTTTTTT
TTTTTFFFFFFFFFFTTTTTTTTTTTTTTTTTTTTTTTTT
TTTTTFFFFFFFFFFTTTTTTTTTTTTTTTTTTTTTTTTT
TTTTTTTTTTTTTTTTTTTTTTTTTTTTTTTTTTTTTTTT
TTTTTTTTTTTTTTTTTTTTTTTTTTTTTTTTTTTTTTTT
TTTTTTTTTTTTTTTTTTTTTTTTTTTTTTTTTTTTTTTT
TTTTTTTTTTTTTTTTTTTTTTTTTTTTTTTTTTTTTTTT
TTTTTTTTTTTTTTTTTTTTTTTTTTTTTTTTTTTTTTTT
TTTTTTTTTTTTTTTTTTTTTTTTTTTTTTTTTTTTTTTT
TTTTTTTTTTTTTTTTTTTTTTTTTTTTTTTTTTTTTTTT
TTTTTTTTTTTTTTTTTTTTTTTTTTTTTTTTTTTTTTTT
TTTTTTTTTTTTTTTTTTTTTTTTTTTTTTTTTTTTTTTT
TTTTTTTTTTTTTTTTTTTTTTTTTTTTTTTTTTTTTTTT
TTTTTTTTTTTTTTTTTTTTTTTTTTTTTTTTTTTTTTTT
TTTTTTTTTTTTTTTTTTTTTTTTTTTTTTTTTTTTTTTT
TTTTTTTTTTTTTTTTTTTTTTTTTTTTTTTTTTTTTTTT
TTTTTTTTTTTTTTTTTTTTTTTTTTTTTTTTTTTTTTTT
TTTTTTTTTTTTTTTTTTTTTTTTTTTTTTTTTTTTTTTT
TTTTTTTTTTTTTTTTTTTTTTTTTTTTTTTTTTTTTTTT
TTTTTTTTTTTTKKKKKKKKKKTTTTTTTTTTTTTTTTTT
TTTTTTTTTTTTKKKKKKKKKKTTTTTTTTTTTTTTTTTT
TTTTTTTTTTTTKKKKKKKKKKTTTTTTTTTTTTTTTTTT
TTTTTTTTTTTTKKKKKKKKKKTTTTTTTTTTTTTTTTTT